                                                                                              
  ------------                   -------------------------        ------                      
  |.$......H.|                 ##+..........g............+########+...F|                      
  |....@.....|                 # |....................$..|        |..b.|                      
  |.F........+################## |...c...................|        --+---                      
  |.....w....|                 # --------------+----------          #                         
  ------------                 #               #                    #                         
                               #               #                    #    ------------------   
                               #               #                    #####+........s.......|   
                               #        -------L--------------------     |............!...|   
       ----------------        #        |..........................|     |..h.............|   
       |..............|        #        |..........................|     -------------+----   
       |......F..b....|        #        |.........>......d.........|                  #       
       |..............+#########        |..........................|             ######       
       -+--------------                 |..........................|             #            
        #                               --------------------L-------         ----+--          
        #########################                           #                |.....|          
                                #                           #                |.g...|          
  ------------------------------+-                ----------+------------    |...b.|          
  |.................s............|           #####+.....................|  ##+.....|          
  |...m.................l........|           #    |....s....r....s......|  # |.....|          
  |...H..........................+############    |.....................+### |..H!.|          
  --------------------------------                -----------------------    -------          
                                                                                              